{
  "a": ["ā", "á", "ǎ", "à", "a"],
  "e": ["ē", "é", "ě", "è", "e"],
  "i": ["ī", "í", "ǐ", "ì", "i"],
  "o": ["ō", "ó", "ǒ", "ò", "o"],
  "u": ["ū", "ú", "ǔ", "ù", "u"],
  "ü": ["ǖ", "ǘ", "ǚ", "ǜ", "ü"],
  "v": ["ǖ", "ǘ", "ǚ", "ǜ", "ü"]
}
